20 20
32 33 33 33 33 33 33 33 33 33 33 33 33 33 33 33 33 33 33 34
42 14 15 16 43 43 43 43 43 43 43 43 43 43 43 43 43 43 43 44
42 43 43 43 43 43 43 43 43 43 43 43 43 43 43 43 43 43 43 44
42 43 43 43 43 43 43 43 43 43 43 43 43 43 43 43 43 43 43 44
42 43 43 43 43 43 43 43 43 43 43 43 43 43 43 43 43 43 43 44
42 43 43 43 43 43 43 43 43 43 43 43 43 43 43 43 43 43 43 44
42 43 43 43 43 43 43 43 43 43 43 43 43 43 43 43 43 43 43 44
42 43 43 43 43 43 43 43 43 43 43 43 43 43 43 43 43 43 43 44
42 43 43 43 43 43 43 43 43 43 43 43 43 43 43 43 43 43 43 44
42 43 43 43 43 43 43 43 43 43 43 43 43 43 43 43 43 43 43 44
42 43 43 43 43 43 43 43 43 43 43 43 43 43 43 43 43 43 43 44
42 43 43 43 43 43 43 43 43 43 43 43 43 43 43 43 43 43 43 44
42 43 43 43 43 43 43 43 43 43 43 43 43 43 43 43 43 43 43 44
42 43 43 43 43 43 43 43 43 43 43 43 43 43 43 43 43 43 43 44
42 43 43 43 43 43 43 43 43 43 43 43 43 43 43 43 43 43 43 44
42 43 43 43 43 43 43 43 43 43 43 43 43 43 43 43 43 43 43 44
42 43 43 43 43 43 43 43 43 43 43 43 43 43 43 43 43 43 43 44
42 43 43 43 43 43 43 43 43 43 43 43 43 43 43 43 43 43 43 44
42 43 43 43 43 43 43 43 43 43 43 43 43 43 43 43 43 43 43 44
52 53 53 53 53 53 53 53 53 53 53 53 53 53 53 53 53 53 53 54
g g g g g g g g g g g g g g g g g g g g
g g g g g g g g g g g g g g g g g g g g
g g g g g g g g g g g g g g g g g g g g
g g g g g g g g g g g g g g g g g g g g
g g g g g g g g g g g g g g g g g g g g
g g g g g g g g g g g g g g g g g g g g
g g g g g g g g g g g g g g g g g g g g
g g g g g g g g g g g g g g g g g g g g
g g g g g g g g g g g g g g g g g g g g
g g g g g g g g g g g g g g g g g g g g
g g g g g g g g g g g g g g g g g g g g
g g g g g g g g g g g g g g g g g g g g
g g g g g g g g g g g g g g g g g g g g
g g g g g g g g g g g g g g g g g g g g
g g g g g g g g g g g g g g g g g g g g
g g g g g g g g g g g g g g g g g g g g
g g g g g g g g g g g g g g g g g g g g
g g g g g g g g g g g g g g g g g g g g
g g g g g g g g g g g g g g g g g g g g
g g g g g g g g g g g g g g g g g g g g